   
     2  3  4  5 <NA>
  1  1 11 20  1   19
  2  0  0  8  3    2
  3  1  2 16  1    1
  4  0  1  2  1    7
  5  0  0  0  0    3
  6  0  0  0  1    1
