   
     2  3  4  5
  1  0 28 20  4
  2  0  1  6  6
  3  1  5 12  3
  4  0  4  5  2
  5  0  2  1  0
  6  0  1  1  0
